a: bir
ability: yetenek
able: yapabilen
about: hakkında
above: yukarıda
accept: kabul etmek
according: göre
account: hesap
across: karşıdan karşıya
act: hareket etmek
action: hareket
activity: aktivite
actually: aslında
add: eklemek
address: adres
administration: yönetim
admit: kabul etmek
adult: yetişkin
affect: etkilemek
after: sonra
again: tekrar
against: karşı
age: yaş
agency: ajans
agent: ajan
ago: önce
agree: katılmak
agreement: anlaşma
ahead: önde
air: hava
all: tümü
allow: izin vermek
almost: neredeyse
alone: yalnız
along: boyunca
already: zaten
also: ayrıca
although: rağmen
always: her zaman
American: Amerikan
among: arasında
amount: miktar
analysis: analiz
and: ve
animal: hayvan
another: başka
answer: cevap
any: herhangi bir
anyone: herhangi birisi
anything: herhangi bir şey
appear: görünmek
apply: uygulamak
approach: yaklaşım
area: bölge
argue: tartışmak
arm: kol
around: etrafında
arrive: varmak
art: sanat
article: makale
artist: sanatçı
as: olarak
ask: sormak
assume: varsaymak
at: de
attack: saldırı
attention: dikkat
attorney: avukat
audience: seyirci
author: yazar
authority: otorite
available: müsait
avoid: kaçınmak
away: uzakta
baby: bebek
back: geri
bad: kötü
bag: çanta
ball: top
bank: banka
bar: bar
base: temel
be: ol
beat: yenmek
beautiful: güzel
because: çünkü
become: olmak
bed: yatak
before: önce
begin: başlamak
behavior: davranış
behind: arkasında
believe: inanmak
benefit: fayda
best: en iyi
better: daha iyi
between: arasında
beyond: ötesinde
big: büyük
bill: fatura
billion: milyar
bit: parça
black: siyah
blood: kan
blue: mavi
board: tahta
body: vücut
book: kitap
born: doğmak
both: her ikisi
box: kutu
boy: erkek çocuk
break: kırmak
bring: getirmek
brother: erkek kardeş
budget: bütçe
build: inşa etmek
building: bina
business: iş
but: ama
buy: satın almak
by: tarafından
call: aramak
camera: kamera
campaign: kampanya
can: yapabilir
cancer: kanser
candidate: aday
capital: sermaye
car: araba
card: kart
care: ilgi
career: kariyer
carry: taşımak
case: durum
catch: yakalamak
cause: neden olmak
cell: hücre
center: merkez
central: merkezi
century: yüzyıl
certain: belli
certainly: kesinlikle
chair: sandalye
challenge: meydan okuma
chance: şans
change: değişiklik
character: karakter
charge: ücretlendirme
check: kontrol etmek
child: çocuk
choice: seçim
choose: seçmek
church: kilise
citizen: vatandaş
city: şehir
civil: sivil
claim: iddia etmek
class: sınıf
clear: açık
clearly: açıkça
close: kapatmak
coach: antrenör
cold: soğuk
collection: koleksiyon
college: üniversite
color: renk
come: gelmek
commercial: ticari
common: ortak
community: topluluk
company: şirket
compare: karşılaştırmak
computer: bilgisayar
concern: endişe
condition: durum
conference: konferans
Congress: Kongre
consider: düşünmek
consumer: tüketici
contain: içermek
continue: devam etmek
control: kontrol
cost: maliyet
could: olabilirdi
country: ülke
couple: çift
course: tabii ki
court: mahkeme
cover: kaplamak
create: yaratmak
crime: suç
cultural: kültürel
culture: kültür
cup: fincan
current: güncel
customer: müşteri
cut: kesmek
dark: karanlık
data: veri
daughter: kız
day: gün
dead: ölü
deal: anlaşma
death: ölüm
debate: tartışma
decade: on yıl
decide: karar vermek
decision: karar
deep: derin
defense: savunma
degree: derece
Democrat: Demokrat
democratic: demokratik
describe: tanımlamak
design: tasarlamak
despite: rağmen
detail: detay
determine: belirlemek
develop: geliştirmek
development: gelişme
die: ölmek
difference: fark
different: farklı
difficult: zor
dinner: akşam yemeği
direction: yön
director: yönetmen
discover: keşfetmek
discuss: tartışmak
discussion: tartışma
disease: hastalık
do: yapmak
doctor: doktor
dog: köpek
door: kapı
down: aşağı
draw: çizmek
dream: rüya
drive: sürmek
drop: düşürmek
drug: ilaç
during: sırasında
each: her biri
early: erken
east: doğu
easy: kolay
eat: yemek
economic: ekonomik
economy : ekonomi
edge: kenar
education: eğitim
effect: etki
effort: çaba
eight: sekiz
either: her ikisi de
election: seçim
else: başka
employee: çalışan
end: son
energy: enerji
enjoy: zevk almak
enough: yeterli
enter: girmek
entire: tüm
environment: çevre
environmental: çevresel
especially: özellikle
establish: kurmak
even: hatta
evening: akşam
event: olay
ever: hiç
every: her
everybody: herkes
everyone: herkes
everything: her şey
evidence: kanıt
exactly: tam olarak
example: örnek
executive: yönetici
exist: var olmak
expect: beklemek
experience: deneyim
expert: uzman
explain: açıklamak
eye: göz
face: yüzleşmek
fact: gerçek
factor: faktör
fail: başarısız olmak
fall: düşmek
family: aile
far: uzak
fast: hızlı
father: baba
fear: korku
federal: federal
feel: hissetmek
feeling: hiss
few: birkaç
field: alan
fight: savaşmak
figure: şekil
fill: doldurmak
film: film
final: son
finally: sonunda
financial: finansal
find: bulmak
fine: iyi
finger: parmak
finish: bitirmek
fire: yangın
firm: firma
first: ilk
fish: balık
five: beş
floor: zemin
fly: uçmak
focus: odaklanmak
follow: izlemek
food: yiyecek
foot: ayak
for: için
force: zorlamak
foreign: yabancı
forget: unutmak
form: biçim
former: eski
forward: ileri
four: dört
free: ücretsiz
friend: arkadaş
from: dan
front: ön
full: tam
fully: tamamen
fun: eğlence
function: fonksiyon
fund: fon
future: gelecek
game: oyun
garden: bahçe
gas: gaz
general: genel
generation: nesil
get: almak
girl: kız
give: vermek
glass: cam
go: gitmek
goal: amaç
good: iyi
government: hükümet
great: harika
green: yeşil
ground: yer
group: grup
grow: büyümek
growth: büyüme
guess: tahmin etmek
gun: silah
guy: adam
hair: saç
half: yarım
hand: el
hang: asmak
happen: olmak
happy: mutlu
hard: zor
have: sahip olmak
he: o
head: baş
health: sağlık
hear: duymak
heart: kalp
heat: ısı
heavy: ağır
help: yardım etmek
her: onun
here: burada
herself: kendisi
high: yüksek
him: onu
himself: kendisi
his: onun
history: tarih
hit: vurmak
hold: tutmak
home: ev
hope: umut
hospital: hastane
hot: sıcak
hotel: otel
hour: saat
house: ev
how: nasıl
however: ancak
huge: büyük
human: insan
hundred: yüz
husband: eş
I: ben
idea: fikir
identify: tanımlamak
if: eğer
image: görüntü
imagine: hayal etmek
impact: etki
important: önemli
improve: geliştirmek
in: içinde
include: dahil etmek
including: dahil olmak üzere
income: gelir
increase: artış
indeed: gerçekten
indicate: belirtmek
individual: bireysel
industry: sanayi
information: bilgi
inside: içinde
instead: yerine
institution: kurum
interest: ilgi
interesting: ilginç
international: uluslararası
into: içine
investment: yatırım
involve: içermek
issue: sorun
it: o
item: madde
its: onun
itself: kendisi
job: iş
join: katılmak
just: sadece
keep: saklamak
key: anahtar
kid: çocuk
kill: öldürmek
kind: çeşit
kitchen: mutfak
know: bilmek
knowledge: bilgi
land: arazi
language: dil
large: büyük
last: son
late: geç
later: daha sonra
laugh: gülmek
law: kanun
lay: yerleştirmek
lead: yönetmek
leader: lider
learn: öğrenmek
least: en az
leave: ayrılmak
left: sol
leg: bacak
legal: yasal
less: daha az
let: izin vermek
letter: mektup
level: seviye
lie: yalan söylemek
life: hayat
light: ışık
like: gibi
likely: muhtemelen
limit: sınır
line: hat
link: bağlantı
list: liste
listen: dinlemek
little: az
live: yaşamak
local: yerel
long: uzun
look: bakmak
lose: kaybetmek
loss: kayıp
lot: çok
love: aşk
low: düşük
machine: makine
magazine: dergi
main: ana
maintain: sürdürmek
major: büyük
majority: çoğunluk
make: yapmak
man: adam
manage: yönetmek
management: yönetim
manager: yönetici
many: birçok
market: pazar
marriage: evlilik
material: malzeme
matter: mesele
may: olabilir
maybe: belki
me: beni
mean: anlamına gelmek
measure: ölçmek
media: medya
medical: tıbbi
meet: tanışmak
meeting: toplantı
member: üye
memory: bellek
mention: bahsetmek
message: mesaj
method: yöntem
middle: orta
might: belki
military: askeri
million: milyon
mind: akıl
minute: dakika
miss: kaçırmak
mission: görev
mistake: hata
mix: karıştırmak
model: model
modern: modern
moment: an
money: para
month: ay
more: daha fazla
morning: sabah
most: en çok
mother: anne
mouth: ağız
move: hareket etmek
movement: hareket
movie: film
much: çok
music: müzik
must: meli
my: benim
myself: kendim
name: isim
nation: ulus
national: ulusal
natural: doğal
nature: doğa
near: yakın
nearly: neredeyse
necessary: gerekli
need: ihtiyaç
network: ağ
never: asla
new: yeni
news: haber
newspaper: gazete
next: sonraki
nice: güzel
night: gece
no: hayır
none: hiçbiri
nor: ne de
north: kuzey
not: değil
note: not
nothing: hiçbir şey
notice: fark etmek
now: şimdi
nuclear: nükleer
number: numara
occur: meydana gelmek
of: nin
off: kapalı
offer: teklif
office: ofis
officer: subay
official: resmi
often: sık sık
oh: ah
oil: yağ
ok: tamam
old: eski
on: üzerinde
once: bir kez
one: bir
only: sadece
onto: üstüne
open: açık
operation: işlem
opportunity: fırsat
option: seçenek
or: veya
order: sipariş
ordinary: sıradan
origin: köken
original: özgün
other: diğer
others: diğerleri
otherwise: aksi takdirde
ought: gerekli
our: bizim
ourselves: kendimizi
out: dışarı
over: üzerinde
overall: genel
own: kendi
owner: sahip
page: sayfa
pain: acı
paint: boya
painting: resim
paper: kağıt
parent: ebeveyn
part: parça
participant: katılımcı
particular: belirli
particularly: özellikle
partner: ortak
party: parti
pass: geçmek
past: geçmiş
path: yol
patient: hasta
pattern: desen
pay: ödeme
peace: barış
people: insanlar
per: her
perform: yapmak
performance: performans
perhaps: belki
period: dönem
person: kişi
personal: kişisel
phone: telefon
physical: fiziksel
pick: toplamak
picture: resim
piece: parça
place: yer
plan: planlamak
plant: bitki
play: oynamak
player: oyuncu
PM: öğleden sonra
point: nokta
police: polis
policy: politika
political: siyasi
politics: siyaset
poor: fakir
popular: popüler
population: nüfus
position: pozisyon
positive: pozitif
possible: mümkün
post: gönderi
potential: potansiyel
power: güç
practice: uygulama
prefer: tercih etmek
preparation: hazırlık
prepare: hazırlamak
present: şimdiki
president: başkan
press: basın
pressure: baskı
pretty: oldukça
prevent: önlemek
price: fiyat
principle: ilke
private: özel
probably: muhtemelen
problem: sorun
process: süreç
produce: üretmek
product: ürün
production: üretim
professional: profesyonel
professor: profesör
program: program
project: proje
property: özellik
protect: koruma
prove: kanıtlamak
provide: sağlamak
public: halka açık
pull: çekmek
purpose: amaç
push: itmek
put: koymak
quality: kalite
question: soru
quick: hızlı
quickly: hızlıca
quiet: sessiz
quite: oldukça
race: yarış
radio: radyo
raise: artırmak
range: menzil
rate: oran
rather: oldukça
reach: ulaşmak
read: okumak
ready: hazır
real: gerçek
reality: gerçeklik
realize: farkına varmak
really: gerçekten
reason: neden
receive: almak
recent: son
recently: son zamanlarda
recognize: tanımak
record: kayıt
red: kırmızı
reduce: azaltmak
reflect: yansıtmak
region: bölge
relate: ilişkili
relationship: ilişki
religious: dini
remain: kalmak
remember: hatırlamak
remove: kaldırmak
report: rapor
represent: temsil etmek
Republican: Cumhuriyetçi
require: gerektirmek
research: araştırma
resource: kaynak
respond: yanıtlamak
response: yanıt
responsibility: sorumluluk
rest: dinlenmek
result: sonuç
return: dönmek
reveal: açığa çıkarmak
rich: zengin
right: doğru
rise: yükselmek
risk: risk
road: yol
rock: kaya
role: rol
room: oda
rule: kural
run: koşmak
safe: güvenli
same: aynı
save: kurtarmak
say: demek
scene: sahne
school: okul
science: bilim
scientist: bilim adamı
score: puan
sea: deniz
season: mevsim
seat: koltuk
second: ikinci
secretary: sekreter
section: bölüm
security: güvenlik
see: görmek
seek: aramak
seem: gibi görünmek
sell: satmak
send: göndermek
senior: kıdemli
sense: anlam
series: dizi
serious: ciddi
serve: hizmet etmek
service: hizmet
set: ayarlamak
seven: yedi
several: birkaç
sex: cinsiyet
sexual: cinsel
shake: sarsılmak
share: paylaşmak
she: o (kadın)
shoot: ateş etmek
short: kısa
should: malı
shoulder: omuz
show: göstermek
side: yan
sign: imzalamak
significant: önemli
similar: benzer
simple: basit
simply: basitçe
since: beri
sing: şarkı söylemek
single: yalnız
sister: kız kardeş
sit: oturmak
site: site
situation: durum
six: altı
size: boyut
skill: beceri
skin: cilt
small: küçük
smile: gülümseme
so: öyle
social: sosyal
society: toplum
soldier: asker
some: bazı
somebody: birisi
someone: birisi
something: bir şey
sometimes: bazen
son: oğul
song: şarkı
soon: yakında
sorry: üzgün
sort: çeşit
sound: ses
source: kaynak
south: güney
southern: güneyli
space: uzay
speak: konuşmak
special: özel
specific: belirli
speech: konuşma
spend: harcamak
sport: spor
spring: bahar
staff: personel
stage: sahne
stand: durmak
standard: standart
star: yıldız
start: başlamak
state: durum
statement: ifade
station: istasyon
stay: kalmak
step: adım
still: hala
stomach: mide
stop: durmak
store: mağaza
story: hikaye
strategy: strateji
street: sokak
strength: güç
strong: güçlü
structure: yapı
student: öğrenci
study: çalışmak
stuff: şeyler
style: tarz
subject: konu
substance: madde
succeed: başarılı olmak
success: başarı
successful: başarılı
such: böyle
sudden: aniden
suffer: acı çekmek
suggest: önermek
summer: yaz
support: destek
suppose: zannetmek
sure: emin
surface: yüzey
system: sistem
table: masa
take: almak
talk: konuşmak
task: görev
tax: vergi
teach: öğretmek
teacher: öğretmen
team: takım
technology: teknoloji
telephone: telefon
television: televizyon
tell: söylemek
ten: on
tend: eğilimli olmak
term: dönem
test: test
than: daha
thank: teşekkür etmek
that: o
the: bu
their: onların
them: onları
themselves: kendileri
then: o zaman
theory: teori
there: orada
these: bu
they: onlar
thing: şey
think: düşünmek
third: üçüncü
this: bu
those: şunlar
though: rağmen
thought: düşünce
thousand: bin
threat: tehdit
three: üç
through: vasıtasıyla
throughout: boyunca
throw: atmak
thus: böylece
time: zaman
to: için
today: bugün
together: birlikte
tonight: bu gece
too: çok
top: üst
total: toplam
tough: zorlu
toward: e doğru
town: kasaba
trade: ticaret
traditional: geleneksel
traffic: trafik
training: eğitim
transfer: aktarmak
travel: seyahat etmek
treat: tedavi etmek
treatment: tedavi
tree: ağaç
trial: deneme
trip: seyahat
trouble: sorun
true: doğru
truth: gerçek
try: denemek
turn: dönmek
TV: TV
two: iki
type: tip
under: altında
understand: anlamak
unit: birim
until: kadar
up: yukarı
upon: üzerine
us: biz
use: kullanmak
usually: genellikle
value: değer
various: çeşitli
very: çok
victim: kurban
view: görünüm
violence: şiddet
visit: ziyaret etmek
voice: ses
vote: oy
wait: beklemek
walk: yürümek
wall: duvar
want: istemek
war: savaş
watch: izlemek
water: su
way: yol
we: biz
weak: zayıf
weapon: silah
wear: giymek
week: hafta
weight: ağırlık
well: iyi
west: batı
western: batı
what: ne
whatever: her neyse
when: ne zaman
where: nerede
whether: olup olmadığı
which: hangisi
while: iken
white: beyaz
who: kim
whole: tüm
whom: kimi
whose: kimi
why: neden
wide: geniş
wife: eş
will: istemek
win: kazanmak
wind: rüzgar
window: pencere
wish: dilemek
with: ile
within: içinde
without: olmadan
woman: kadın
wonder: merak etmek
word: kelime
work: çalışmak
worker: işçi
world: dünya
worry: endişelenmek
would: olurdu
write: yazmak
writer: yazar
wrong: yanlış
yard: avlu
yeah: evet
year: yıl
yes: evet
yet: henüz
you: sen
young: genç
your: senin
yourself: kendin
youth: gençlik
zone: bölge